13 7 6 10 15 2 7 13 10 17 6 5 19 20
14 4 13 9 3 16 16 18 20 18 16 6 3 10 10
14 2 15 2 13 5 16 7 13 20 13 11 10 16 17
15 7 17 6 9 20 14 13 14 2 12 18 1 8 16 3
17 6 14 12 7 17 8 7 5 11 6 11 12 1 15 8 18 1
17 5 7 12 9 2 2 18 11 18 8 12 17 9 1 9 3 17
19 14 9 8 2 9 14 3 15 4 13 8 10 11 13 6 3 15 12 7
20 4 14 12 14 16 18 7 14 16 10 15 4 15 10 9 2 20 4 9 2
21 16 15 7 17 7 9 4 12 2 9 3 8 17 16 10 3 11 20 11 7 6
21 17 1 1 3 2 7 5 13 20 5 18 8 2 17 10 19 4 17 16 17 6
22 18 8 20 19 15 18 11 3 5 6 18 8 7 3 8 9 13 20 18 15 16 5
23 16 15 2 19 18 14 5 3 5 5 18 15 15 17 13 7 9 13 5 11 9 18 10
24 18 12 16 5 1 5 14 4 2 20 6 19 5 15 20 19 14 6 10 7 10 9 2 6
24 9 15 5 9 13 13 9 15 1 20 6 20 6 8 2 4 1 11 13 14 9 20 8 6
26 11 11 1 13 12 13 2 17 18 10 6 8 1 15 4 3 11 18 12 15 6 5 9 16 19 2
26 20 6 5 3 16 15 16 12 11 10 10 2 17 20 10 4 4 3 15 1 3 3 15 12 17 1
27 11 5 15 6 4 14 7 18 10 5 20 4 10 13 5 11 3 18 12 10 8 10 7 13 4 16 12
27 11 12 16 16 14 9 14 3 9 16 19 5 2 13 11 10 8 9 20 17 9 13 2 20 8 13 17
28 9 5 5 14 2 8 3 13 10 9 17 15 19 15 3 15 2 17 15 1 6 12 16 3 2 8 18 16
28 9 18 7 4 8 5 5 5 6 2 12 9 10 6 5 18 11 12 14 3 13 4 17 8 13 8 10 18
29 10 1 19 5 1 17 1 2 19 13 14 6 12 20 6 11 2 15 7 2 1 19 18 2 15 16 4 2 17
30 9 13 5 9 17 5 8 8 2 7 7 11 12 17 7 4 7 2 8 7 20 7 5 17 20 15 19 14 19 8
31 15 6 2 8 5 3 8 7 20 15 10 11 8 16 9 13 5 20 20 19 13 6 19 7 18 17 1 14 16 2 6
31 4 18 7 7 2 3 13 17 6 14 6 19 14 10 1 11 17 8 15 2 5 20 1 12 10 9 20 4 19 7 16
31 8 2 8 7 14 2 4 18 18 13 19 9 9 4 12 6 16 16 12 16 6 4 12 3 6 16 18 9 9 19 15
33 6 10 6 5 7 3 11 2 10 16 17 16 6 12 17 16 3 3 17 13 16 20 8 12 10 13 7 6 5 1 15 15 14
33 17 7 2 4 1 18 5 2 12 14 2 2 13 20 16 19 19 6 11 5 9 2 9 12 1 3 9 8 12 2 6 7 7
35 16 3 4 19 10 12 16 9 4 15 7 8 20 11 14 14 7 5 19 14 20 17 14 20 9 6 5 8 11 14 17 6 6 4 12
35 2 14 18 20 18 4 3 12 11 18 1 19 13 3 1 17 12 3 2 17 11 18 15 8 9 1 5 9 9 14 18 18 7 2 4
35 11 9 13 6 20 19 1 3 13 17 12 17 11 17 13 3 20 8 6 3 10 19 1 18 12 4 12 11 8 15 11 16 17 17 1
36 9 15 10 10 3 13 8 19 19 1 3 7 20 12 11 6 10 18 12 6 9 16 12 1 10 13 5 10 18 7 11 10 8 7 17 18
36 15 2 6 9 18 8 4 9 2 8 2 14 13 4 14 20 14 1 15 1 3 19 19 1 15 16 20 12 12 11 8 19 12 17 11 2
37 12 16 5 14 17 15 12 14 14 8 17 12 19 18 13 12 4 5 7 18 18 15 6 20 4 8 15 14 6 6 19 15 13 1 10 7 17
37 9 10 4 15 8 13 17 20 14 13 16 8 4 15 10 6 5 17 9 5 5 14 11 19 14 19 11 13 16 20 10 1 6 3 11 16 10
39 12 8 17 17 7 18 14 8 7 13 11 1 16 18 1 4 1 13 2 5 2 15 15 1 5 17 4 17 12 14 17 9 7 2 18 13 18 14 6
40 9 15 12 1 11 16 12 8 3 3 3 3 20 7 20 6 7 14 16 11 4 6 16 8 12 2 12 17 13 17 2 11 20 8 14 8 16 17 17 20
40 4 12 7 5 18 12 20 16 6 4 2 5 16 6 14 12 9 16 7 2 18 20 18 9 18 13 7 10 9 5 10 20 17 20 4 8 19 16 1 11
41 3 11 11 17 7 16 13 11 18 13 16 4 14 8 7 19 14 17 17 4 18 2 20 8 5 9 1 7 11 12 18 1 3 14 7 14 13 20 6 9 8
42 16 7 16 10 5 16 9 20 7 19 14 13 1 3 16 11 14 15 11 12 7 1 14 18 3 6 12 19 2 13 13 18 7 2 13 2 4 4 20 5 15 1
43 12 4 7 5 3 14 11 15 8 7 14 9 20 7 8 19 8 7 18 18 7 18 12 5 6 5 10 5 5 17 3 14 15 17 11 12 8 18 13 5 4 15 16
45 18 13 15 16 6 17 9 9 1 11 16 5 14 2 20 10 20 17 6 20 6 6 20 1 4 3 6 1 18 10 17 12 7 4 15 2 13 5 6 20 15 10 20 4 19
46 10 19 15 12 16 4 6 14 11 4 19 15 4 14 6 10 16 11 16 4 5 1 19 13 1 19 8 9 9 8 9 9 13 8 3 19 15 12 5 5 16 15 13 18 7 18
47 17 15 4 7 4 5 15 6 1 6 16 1 5 12 14 18 4 15 2 10 2 18 7 16 19 12 6 10 2 2 9 17 19 1 6 12 1 1 2 4 6 9 13 6 20 10 7
49 14 3 7 11 20 18 9 6 14 12 7 15 9 16 16 7 4 14 8 14 12 7 7 8 13 8 8 14 13 20 14 5 10 3 9 12 9 2 2 19 6 12 13 5 18 3 12 8 14
49 15 10 14 20 7 14 20 12 16 2 10 7 14 17 2 15 17 5 18 17 4 6 9 1 4 13 9 15 11 18 8 16 17 5 14 7 19 8 20 12 10 4 10 10 16 20 11 3 12
50 20 4 9 4 15 11 19 12 8 14 9 2 16 16 15 17 11 7 15 17 6 20 18 19 5 18 3 14 3 20 8 16 2 16 15 15 18 13 16 8 20 12 1 13 12 3 8 3 11 6
51 7 18 9 2 10 8 2 4 14 6 11 1 5 9 16 10 13 17 12 11 13 12 17 6 18 18 5 10 7 20 12 17 9 11 10 19 14 20 10 18 9 9 19 19 18 9 12 2 1 9 19
52 20 6 5 20 15 12 12 5 11 13 3 20 20 7 11 6 20 3 6 13 1 16 6 11 16 11 19 19 8 6 15 4 17 12 20 10 5 7 3 13 19 6 4 10 18 11 4 3 7 10 3 4
53 10 20 15 8 12 14 19 12 13 5 9 6 5 12 20 20 6 15 4 8 16 4 16 7 12 16 1 18 6 4 19 13 14 19 5 6 8 3 4 9 5 9 3 9 3 1 19 10 7 17 14 1 8
54 13 7 14 6 17 9 8 18 14 6 10 9 15 10 2 19 4 6 7 8 3 15 9 19 6 18 11 19 3 7 11 19 12 9 2 18 15 19 15 16 2 18 9 10 16 18 3 19 13 2 16 15 15 9
56 7 3 16 8 10 18 2 7 2 19 16 20 19 6 12 15 14 8 14 14 14 17 3 8 17 1 17 3 7 11 4 4 18 17 6 4 14 1 17 19 7 1 20 5 3 19 8 16 15 20 18 12 7 11 1 4
56 7 4 15 19 20 15 19 14 8 5 17 20 13 16 12 11 16 6 16 2 20 10 14 16 10 11 1 6 18 4 5 6 15 16 7 8 20 7 2 9 3 1 19 1 2 9 1 10 4 6 16 2 13 16 8 11
57 5 2 8 3 2 7 2 5 15 8 17 9 19 11 6 2 7 20 14 1 3 11 13 5 19 6 1 15 18 9 17 12 19 12 4 15 7 15 1 3 10 14 15 17 20 6 8 10 3 2 4 11 4 17 15 20 19
58 13 16 4 14 10 8 20 15 2 18 11 3 4 15 16 10 9 6 9 15 8 11 12 14 10 7 6 19 7 15 6 13 6 1 11 16 3 14 4 11 18 16 16 6 13 4 12 16 6 12 13 1 13 16 17 15 12 14
61 14 7 2 8 11 20 17 6 16 11 10 7 15 20 6 3 3 3 16 6 8 20 15 16 17 2 15 6 12 17 10 16 17 14 15 20 13 17 13 9 20 8 7 19 13 15 7 2 12 9 9 2 10 20 2 18 15 11 4 5 12
63 9 1 18 14 3 9 8 19 14 20 18 17 7 10 5 13 5 16 11 1 12 8 9 10 11 2 2 19 18 20 10 7 15 19 3 15 10 15 3 15 5 8 16 7 5 11 16 11 1 15 14 4 16 19 11 19 2 6 4 17 8 8 8
64 13 4 15 9 16 20 6 13 8 20 13 18 12 19 13 5 2 7 6 13 11 13 1 18 13 4 9 4 16 18 18 6 8 1 9 13 13 8 14 20 5 12 8 6 4 11 6 8 2 16 8 15 9 17 18 7 4 9 13 20 20 11 19 3
65 13 1 2 16 19 20 1 17 18 11 7 9 20 2 19 17 14 16 14 4 13 10 19 4 7 5 20 1 16 10 4 4 7 1 7 18 12 17 10 17 14 9 14 4 19 5 5 14 5 15 19 7 15 3 18 15 6 16 15 14 5 3 20 11 5
66 4 15 3 12 6 18 3 11 8 6 10 13 7 10 2 20 6 15 6 8 19 10 8 10 18 9 10 18 2 20 20 17 8 17 14 1 4 5 8 9 7 15 13 1 5 3 19 9 6 6 7 15 16 1 11 8 18 3 5 17 11 4 11 4 14 20
66 14 9 10 8 10 20 1 9 14 18 4 1 3 9 19 4 1 17 18 3 18 18 7 15 10 7 13 16 7 11 4 18 6 4 12 18 20 18 16 20 15 11 16 20 11 11 5 10 9 16 6 4 18 4 15 13 13 5 14 6 17 12 8 19 18 16
70 13 15 3 1 4 13 11 9 13 7 3 14 7 9 7 12 11 2 3 7 1 2 8 9 14 15 1 4 13 9 6 12 11 11 3 18 2 9 10 10 4 4 14 19 14 5 5 16 10 15 19 17 4 19 10 16 1 15 20 10 7 7 11 5 4 2 3 4 4 18
70 13 12 19 9 10 8 13 14 12 8 14 3 1 18 5 4 11 9 5 19 7 5 18 17 13 11 18 1 15 6 18 5 3 1 16 18 20 10 10 15 6 5 17 9 6 17 13 18 14 20 15 9 10 9 1 12 12 20 2 3 16 17 10 14 2 12 8 4 13 18
71 7 18 14 9 14 8 7 19 20 6 18 17 7 2 11 11 9 20 17 13 20 10 10 14 12 6 16 1 1 20 17 9 10 16 2 13 19 6 20 7 9 19 9 16 4 4 17 19 5 4 12 19 20 5 20 6 19 20 6 4 3 14 17 17 5 14 6 13 13 7 7
72 14 8 14 4 3 8 11 17 2 5 12 7 10 8 14 14 13 19 11 16 16 16 17 3 20 9 18 4 14 7 2 1 12 5 2 3 3 6 2 3 15 9 20 18 9 18 3 9 20 7 15 2 9 18 3 19 6 20 3 15 10 3 20 10 15 13 9 19 8 4 1 2
72 13 13 18 18 15 1 6 9 2 19 20 4 6 3 18 8 1 8 7 13 2 7 18 14 19 4 8 6 1 2 5 10 15 19 16 18 2 9 2 17 11 1 4 11 6 10 14 15 20 12 12 10 3 11 15 5 4 11 13 19 20 15 16 1 3 10 6 5 19 8 5 16
72 5 18 8 16 10 15 15 5 20 12 8 10 1 1 2 15 12 11 17 13 18 4 7 1 19 5 17 20 4 7 1 18 8 4 5 13 7 12 3 13 19 19 7 20 12 4 2 18 16 9 4 6 20 18 3 18 9 11 1 12 15 8 1 1 11 16 1 9 2 18 19 18
77 17 17 19 14 16 16 8 5 19 5 8 8 17 13 10 14 9 18 5 19 19 18 3 11 17 9 3 7 12 2 7 9 8 10 14 14 8 1 11 3 16 9 12 18 19 10 10 14 13 8 18 13 12 14 12 20 20 3 7 20 8 5 3 19 19 20 18 18 16 10 2 7 20 8 5 4 20
79 2 4 10 19 11 4 6 3 20 12 9 2 3 8 15 3 15 4 11 16 16 18 9 6 17 6 5 17 15 9 8 15 8 16 16 18 20 7 8 12 2 1 3 11 14 6 16 17 9 8 19 14 2 18 6 11 4 6 17 16 2 8 4 3 4 15 20 7 13 17 8 9 10 12 14 19 1 16 1
80 17 16 3 13 5 9 7 9 20 13 10 18 10 19 7 19 11 13 8 14 15 13 9 20 8 2 2 12 16 3 10 4 11 14 17 18 16 6 12 10 4 16 14 1 4 1 3 4 6 9 1 15 13 1 18 20 10 8 15 18 16 13 17 20 20 10 3 11 12 9 14 12 13 2 7 3 5 12 5 7
80 8 1 1 5 18 12 13 19 4 7 2 1 18 12 14 15 12 18 17 8 11 13 18 11 2 4 2 6 9 7 2 8 20 10 19 11 8 9 12 12 10 4 12 18 18 20 10 20 18 1 17 5 15 9 13 19 11 20 15 4 11 7 2 17 12 19 2 13 15 19 6 20 15 3 2 3 1 6 3 13
81 4 12 5 5 8 6 13 9 14 17 17 13 8 18 1 17 11 10 18 3 10 15 16 10 14 17 7 10 1 19 5 17 10 18 12 2 10 16 10 19 2 14 8 19 4 7 6 17 19 16 12 5 5 3 18 1 13 19 7 2 6 13 6 17 16 10 17 13 8 14 20 10 19 6 4 19 10 4 12 14 14
81 6 11 13 7 15 19 4 17 9 3 13 16 7 9 7 16 9 8 5 6 5 11 3 10 12 20 1 6 20 12 2 8 8 16 12 6 17 2 13 13 12 3 15 18 9 6 4 2 4 12 15 10 1 17 5 10 4 18 17 12 12 7 2 19 12 9 17 7 8 2 4 3 18 1 2 14 10 16 17 14 1
86 10 12 1 5 18 11 8 9 1 17 2 20 3 18 15 12 12 4 9 13 9 16 10 19 10 1 16 5 18 9 20 19 10 9 4 10 12 7 20 17 16 3 19 12 2 20 20 10 5 19 7 4 3 18 18 5 8 2 11 10 4 17 19 13 6 15 3 10 8 19 10 18 15 14 6 11 2 17 6 2 16 19 17 16 16 7
87 10 1 8 20 14 20 10 1 3 19 10 16 7 13 19 14 19 14 3 14 16 10 18 8 17 16 3 14 5 19 9 15 11 13 11 16 17 19 2 7 12 4 8 2 16 20 19 1 19 6 7 15 20 7 9 16 18 7 8 10 5 14 19 2 20 6 3 6 17 2 5 17 12 8 11 12 16 20 19 1 5 7 12 18 15 10 15
88 3 16 18 8 4 17 7 8 15 17 18 15 16 14 9 5 12 2 17 14 20 7 7 3 16 10 18 11 2 20 14 10 16 12 6 16 1 10 20 3 12 5 14 20 4 11 15 20 17 8 11 3 18 10 8 15 20 19 20 7 6 19 19 2 10 8 2 17 5 19 10 16 9 19 5 8 16 18 1 9 9 9 8 14 8 11 9 8
89 18 2 18 9 14 18 13 1 4 18 20 1 19 1 9 6 12 5 7 14 2 10 12 15 1 2 1 19 12 1 11 4 11 4 14 10 9 12 14 12 17 1 13 3 5 16 20 10 13 5 8 1 14 18 3 18 6 20 10 16 18 13 2 6 2 14 5 17 5 14 18 19 6 19 4 13 9 13 15 13 1 3 15 9 8 6 1 18 9
89 15 16 16 11 6 19 9 7 10 11 19 11 2 7 15 4 17 17 16 20 8 15 1 6 14 16 2 4 6 10 11 10 14 7 14 12 15 6 9 14 19 9 6 8 12 13 16 13 20 3 7 14 16 20 4 12 15 5 13 7 19 17 9 11 14 20 6 15 1 8 16 4 12 10 15 6 18 7 20 11 14 8 9 11 17 10 18 16 5
90 6 8 19 9 10 8 4 9 12 11 6 16 16 8 4 14 7 5 1 5 1 16 19 7 11 1 13 19 10 7 2 5 13 19 5 14 20 11 4 7 5 16 10 20 11 17 5 1 16 20 10 14 8 5 17 11 1 11 11 19 7 14 4 16 14 6 3 8 19 16 18 11 8 13 5 17 20 17 1 14 11 8 6 15 4 13 12 9 15 4
95 11 15 7 8 20 20 18 14 3 16 9 15 7 3 3 20 6 15 12 11 8 15 10 3 12 20 14 10 3 15 4 10 9 20 11 20 14 9 16 12 17 4 18 4 16 14 20 6 11 14 12 2 18 2 16 5 17 2 5 16 5 6 9 15 3 5 6 19 17 14 4 3 9 1 4 11 6 6 9 12 11 1 14 13 6 19 9 15 11 12 14 13 12 4 8
96 15 10 5 12 11 10 2 19 5 4 17 3 15 12 15 18 13 9 8 8 13 5 12 10 5 15 15 17 5 2 2 3 6 1 7 12 5 3 10 5 9 14 19 20 19 4 10 4 9 13 1 6 3 13 17 18 19 11 15 4 7 8 9 8 9 3 14 20 6 6 2 4 14 8 17 11 3 16 20 10 7 3 13 7 17 5 19 8 9 3 18 13 9 3 10 7
97 17 7 8 7 19 6 5 7 1 5 5 15 7 7 12 12 16 16 6 5 2 16 15 1 3 4 20 10 11 17 9 9 1 6 12 11 15 3 5 2 19 12 9 19 1 5 6 19 18 17 11 20 20 17 10 8 9 16 14 12 4 16 15 7 3 13 10 15 6 2 3 18 19 14 19 7 4 18 13 6 2 15 4 12 20 16 18 8 10 5 1 2 8 10 1 15 20
99 11 18 6 16 11 12 8 14 17 12 17 16 9 2 18 20 2 14 12 8 17 11 19 10 9 13 9 2 15 12 3 13 15 11 15 18 3 3 6 14 6 3 4 2 17 12 8 3 1 3 20 3 7 4 5 11 7 1 17 15 7 6 13 15 15 5 17 9 19 19 1 6 5 2 13 7 19 19 6 13 15 7 9 13 15 17 11 17 7 3 12 10 6 18 20 6 8 12 5
99 19 3 20 19 2 9 3 5 13 8 10 20 18 5 8 20 18 4 1 8 15 16 11 20 4 13 19 9 8 17 15 17 19 10 17 20 13 5 13 15 2 15 15 5 2 1 13 16 17 16 11 2 10 20 13 1 1 16 9 5 12 9 5 4 16 11 1 18 6 12 19 14 12 4 20 4 17 12 5 6 7 13 15 11 8 12 18 11 13 18 20 3 4 10 6 4 9 10 4
100 6 19 5 19 7 13 8 4 20 3 14 10 6 18 13 4 13 9 4 16 3 20 16 19 17 1 7 17 4 11 7 18 12 4 6 19 2 7 5 3 1 2 5 10 6 20 11 3 17 14 12 6 2 1 2 5 16 3 15 8 13 14 10 5 7 2 14 2 17 17 9 9 3 12 11 6 7 5 10 3 9 13 10 14 6 15 9 19 9 16 20 13 8 5 11 11 6 7 13 17
101 5 12 12 8 19 8 16 6 15 19 4 7 4 9 19 2 20 6 5 11 9 2 13 2 20 16 19 8 1 9 15 15 12 5 4 3 16 20 9 14 5 1 17 11 9 19 17 8 12 2 3 4 2 5 6 6 17 18 11 7 9 11 14 9 19 4 6 10 11 8 2 5 1 3 20 4 4 17 17 12 16 4 6 16 9 13 10 7 19 16 7 7 19 18 18 13 19 4 3 5 20
101 8 12 20 5 7 17 11 11 3 17 8 8 4 6 11 20 8 8 2 16 17 20 3 11 6 8 8 14 7 15 10 1 6 15 14 7 13 16 5 8 18 4 1 11 9 2 13 5 6 4 8 14 11 9 13 4 4 7 18 9 17 12 8 19 10 18 12 14 10 15 16 17 20 10 18 20 11 15 6 4 9 13 13 18 17 10 17 3 20 8 11 10 18 4 3 16 9 1 1 19 2
102 10 16 11 13 8 6 15 8 12 6 9 3 14 4 18 4 4 19 8 14 17 7 7 20 2 20 13 11 14 18 5 6 15 13 18 19 13 14 10 3 6 9 15 17 2 19 16 1 5 4 8 1 17 19 1 12 19 10 3 9 4 10 3 20 15 3 9 15 14 15 5 18 6 19 9 13 6 5 6 12 2 19 6 20 11 6 12 13 15 11 19 19 6 6 15 20 4 15 2 1 19 18
102 10 9 8 9 1 11 14 12 15 18 5 16 12 14 10 14 20 1 17 7 18 15 14 18 11 1 1 17 13 5 10 13 9 15 19 18 12 9 18 19 6 6 20 6 14 18 18 1 20 13 3 3 18 4 10 13 13 10 17 4 8 8 18 7 3 14 20 13 18 14 20 8 15 15 13 12 18 14 2 16 13 14 16 8 2 7 3 1 8 3 5 2 12 20 12 4 11 18 20 19 8 15
102 19 1 11 1 14 11 8 17 14 16 15 2 11 13 2 11 14 2 17 20 15 5 4 12 2 16 11 12 9 8 3 13 19 15 9 3 3 16 3 20 8 9 2 9 11 15 10 4 19 8 17 6 7 15 6 16 8 9 12 14 14 14 5 6 17 18 10 1 18 1 15 20 9 11 15 16 1 18 19 7 12 17 13 7 20 12 3 5 10 19 4 14 2 19 13 9 8 14 15 5 18 3
103 7 18 17 7 20 4 2 20 17 19 12 3 1 8 7 17 7 14 11 12 5 17 3 7 13 13 20 4 18 12 18 11 19 18 14 18 6 13 9 2 12 15 17 11 8 3 13 6 19 17 19 16 18 5 12 13 19 10 13 13 7 9 11 16 7 9 14 7 16 7 19 14 14 2 5 19 2 17 8 5 3 2 3 9 6 20 13 9 20 7 17 18 4 7 9 18 19 1 20 13 13 11 15
104 13 15 9 14 16 5 19 13 4 12 9 19 16 1 16 6 18 12 17 20 1 1 17 9 17 9 19 6 15 6 17 2 5 2 4 3 7 12 12 8 8 12 16 9 14 14 1 3 3 10 19 17 17 20 4 1 13 1 14 11 13 5 1 1 20 10 1 4 1 8 3 9 18 2 17 10 6 15 12 2 14 9 14 13 3 16 13 5 8 8 20 1 14 5 11 14 5 13 9 13 14 4 11 1
105 10 14 1 12 4 10 15 9 15 10 14 9 13 17 15 10 16 13 10 18 16 1 13 14 15 13 17 10 4 14 10 5 13 17 2 5 17 7 13 15 13 18 8 19 17 17 14 12 18 12 15 7 20 13 19 13 11 14 13 19 16 15 7 8 1 12 6 18 18 9 12 19 7 11 6 16 6 7 7 5 12 18 19 3 17 19 14 15 16 9 12 4 5 17 13 2 7 16 11 2 19 8 9 3 12
106 10 9 14 13 13 2 9 7 10 1 1 6 19 16 15 18 6 13 9 17 13 16 18 8 12 2 11 5 10 12 16 18 11 11 16 16 10 19 20 9 17 14 17 2 11 11 1 13 13 9 9 11 8 13 20 18 7 17 9 13 16 17 15 5 1 2 7 14 8 17 8 1 7 2 2 5 12 1 2 5 20 17 10 5 2 14 13 18 12 2 11 5 4 7 14 11 14 16 19 19 20 1 20 12 4 11
106 3 16 5 11 12 2 18 18 11 15 1 3 1 6 10 20 3 5 9 12 11 15 17 1 13 20 7 5 1 9 4 1 14 3 20 16 6 4 3 12 4 5 18 11 6 4 20 6 4 18 3 20 14 6 1 2 5 2 13 13 5 7 13 7 8 20 15 14 18 16 2 1 14 13 8 14 20 10 4 14 15 1 10 20 17 18 19 4 10 15 8 10 20 3 9 5 11 13 2 7 9 4 1 14 18 17
108 11 11 11 11 5 6 20 12 2 2 14 10 6 15 4 5 13 1 19 3 8 8 3 17 3 10 4 12 4 19 12 14 4 9 11 2 19 8 14 16 8 20 4 4 16 18 4 20 4 11 2 5 5 7 8 14 6 7 4 9 6 12 10 20 13 14 3 10 18 15 20 16 20 20 15 10 5 7 13 17 12 14 15 3 3 18 18 19 9 18 10 20 7 5 9 6 12 20 3 6 3 16 17 5 4 17 11 3
108 15 11 7 7 12 16 12 13 18 3 5 13 3 1 3 5 10 17 19 14 3 6 12 10 1 14 1 13 8 9 16 18 2 10 6 5 18 9 1 5 6 7 10 14 20 18 2 5 14 11 2 16 18 17 12 11 13 14 6 4 17 11 20 4 2 15 20 3 1 5 6 1 14 14 14 17 7 12 9 4 11 13 13 8 1 12 3 15 15 20 8 5 8 10 10 5 2 12 18 12 14 3 5 11 12 6 15 5
109 20 1 14 7 20 4 17 17 6 4 3 10 1 13 1 10 2 9 6 2 7 17 1 15 18 17 16 1 7 1 2 11 5 13 16 9 18 15 12 1 8 6 5 17 8 17 16 6 9 11 15 15 1 7 1 14 4 15 17 8 2 4 8 3 4 17 13 2 15 4 17 6 6 10 20 16 14 5 14 8 5 10 14 13 7 1 3 9 6 15 2 12 7 8 2 17 2 4 7 16 13 5 1 17 15 9 9 10 20
109 12 14 13 6 17 1 6 16 18 5 17 17 3 6 9 16 4 5 7 11 17 15 8 12 13 12 2 20 10 1 15 5 4 13 9 10 4 5 7 20 3 2 19 16 16 3 20 14 13 16 19 1 19 14 6 9 19 12 12 8 9 15 2 17 15 13 17 19 5 11 19 13 17 6 8 5 5 14 2 3 2 6 1 6 1 4 14 19 16 3 6 8 11 6 7 7 1 2 16 1 15 3 5 11 18 8 1 4 1
109 17 9 6 9 3 20 13 14 20 16 19 20 6 7 20 8 18 9 20 15 14 16 15 12 18 17 17 7 5 3 12 6 4 4 6 6 6 2 14 4 7 16 5 15 6 4 18 16 16 8 5 9 6 19 19 9 10 4 1 12 4 20 8 18 3 18 8 2 7 6 9 9 9 18 5 1 3 2 15 17 5 14 5 13 12 16 7 6 17 11 18 17 12 2 17 1 7 13 3 17 13 16 3 9 2 3 5 2 14
109 5 16 4 4 4 14 7 19 19 12 1 14 17 18 1 10 13 1 16 20 11 2 13 18 18 10 11 12 19 17 2 12 1 10 17 15 5 1 10 12 1 2 4 5 20 15 14 3 15 12 6 20 16 13 3 13 11 19 19 10 19 4 19 3 7 3 10 14 20 12 1 2 9 6 12 2 13 11 12 14 1 17 17 3 10 17 20 14 12 14 12 17 14 1 7 11 11 4 20 19 11 13 19 19 9 13 8 12 10
