1 18
6 96 172 212 247 120 157
7 77 130 149 82 13 81 99
9 151 158 146 146 131 137 6 5 126
10 246 205 1 24 72 51 224 164 62 127
10 31 115 255 44 205 157 125 67 210 13
10 42 162 105 90 143 11 183 98 154 43
11 42 59 0 95 140 56 81 191 180 166 134
14 26 174 67 147 2 151 93 214 142 223 57 30 41 183
15 239 83 89 18 207 23 201 231 239 78 97 131 160 132 218
15 7 164 28 7 29 229 102 15 246 16 139 76 88 239 52
16 142 151 57 220 221 193 63 48 151 95 28 113 119 110 216 157
16 21 225 38 35 9 203 41 233 35 124 190 183 24 216 132 122
16 26 205 97 187 205 169 195 171 139 245 189 237 123 175 48 41
16 40 32 68 48 147 237 215 242 30 205 96 75 59 111 17 3
17 143 133 26 127 211 123 2 115 0 220 16 50 2 104 0 241 42
19 211 207 237 0 105 58 94 242 76 67 91 12 195 194 135 222 76 189 174
20 183 92 85 0 77 105 27 55 56 182 207 20 246 121 11 215 24 203 124 225
21 17 228 105 192 128 103 122 27 138 54 207 54 156 104 127 77 238 134 225 148 116
22 188 112 137 171 36 160 109 215 133 216 105 0 11 184 106 156 164 29 88 37 163 37
22 26 45 231 175 136 173 87 170 82 96 210 147 162 248 87 45 245 34 174 186 7 214
26 144 213 178 175 94 163 99 201 201 111 159 3 31 155 254 247 24 209 249 187 128 174 12 165 18 28
27 13 30 0 113 240 155 68 237 125 116 84 121 119 141 156 168 183 123 3 43 103 202 243 175 216 224 248
27 202 56 242 17 34 151 236 85 171 17 197 115 20 19 182 190 146 55 25 217 58 39 229 205 148 200 215
29 63 189 235 246 100 207 118 56 237 75 68 194 115 160 166 254 139 248 144 137 9 112 11 190 130 227 234 16 160
30 251 25 250 138 145 19 179 117 43 4 9 146 125 82 74 53 209 95 48 245 21 13 248 13 183 178 74 254 79 191
31 249 111 93 201 99 15 154 73 46 133 143 51 248 250 108 111 247 62 144 115 14 219 19 36 7 146 70 242 163 238 146
31 73 198 129 72 150 183 167 228 128 212 30 213 11 213 39 92 228 139 235 82 146 253 17 224 130 181 18 215 44 142 189
33 184 101 71 87 104 128 42 81 171 203 68 77 134 219 245 101 229 187 19 76 82 124 121 108 175 112 10 174 79 152 193 7 254
34 68 157 228 55 47 94 164 131 143 120 25 41 228 24 81 148 102 120 72 184 184 127 21 251 36 181 220 3 248 170 185 61 71 157
35 253 143 113 80 5 101 227 230 213 119 156 30 141 123 68 0 228 141 183 26 157 52 176 201 14 64 252 176 178 198 21 175 85 135 255
36 114 131 56 81 25 23 71 185 246 74 51 93 130 195 161 102 157 35 49 57 251 84 33 232 46 146 87 191 88 137 61 202 12 117 27 38
36 226 65 194 89 221 224 231 88 37 231 60 178 158 86 79 210 6 24 224 70 21 144 248 219 166 167 48 45 166 138 25 136 203 219 225 168
37 112 237 180 8 3 196 173 91 177 184 220 243 37 137 149 171 230 147 55 42 46 4 162 148 105 171 34 176 59 30 190 171 11 115 179 14 55
37 13 65 154 101 121 196 19 196 231 34 226 15 67 191 51 58 134 28 133 50 234 136 83 14 174 24 141 239 110 169 173 123 235 72 224 100 12
37 86 34 165 91 27 144 156 125 183 37 220 88 56 42 174 74 34 15 30 40 32 221 36 247 199 233 75 172 205 3 32 36 37 197 127 65 85
38 127 229 229 139 158 81 211 111 235 203 131 206 87 64 78 145 156 234 186 156 64 108 16 178 101 185 176 73 58 35 113 185 9 86 69 167 168 24
38 227 153 98 59 217 176 204 117 154 134 18 218 243 34 140 88 220 61 161 22 96 19 207 105 105 20 16 17 44 38 165 16 191 7 75 152 183 23
38 240 197 247 86 147 242 226 215 227 108 234 250 246 214 134 93 162 143 170 99 105 176 47 148 146 200 228 153 43 33 11 27 231 3 113 122 245 84
42 39 163 91 70 186 216 223 104 172 125 162 65 232 222 152 33 120 10 216 99 139 249 135 206 48 245 137 251 222 150 47 5 57 139 75 243 99 42 92 15 168 254
43 126 117 42 27 226 102 83 26 246 128 66 4 158 152 208 96 190 193 114 165 162 231 87 39 254 121 13 70 175 59 24 45 177 67 73 147 169 156 173 159 28 240 163
43 143 107 117 249 52 138 211 225 94 123 94 99 34 238 60 57 69 80 79 26 61 20 45 211 119 110 15 11 71 239 200 214 90 61 208 142 199 163 111 38 30 206 137
43 172 65 49 98 173 73 52 126 11 173 165 216 213 12 18 243 150 133 196 3 14 2 153 17 141 69 165 240 89 197 173 5 6 222 104 179 39 156 49 51 73 215 11
44 146 217 146 113 3 1 251 32 43 253 99 73 212 193 56 227 52 226 115 50 38 76 153 163 71 12 207 85 50 67 114 197 28 4 54 32 6 49 64 49 46 163 123 2
45 138 54 97 109 27 235 238 49 131 63 186 191 17 66 79 16 193 176 175 139 245 22 230 211 193 90 105 215 102 234 232 240 32 73 93 59 53 75 108 184 138 38 119 155 105
46 147 149 200 231 46 170 107 105 224 79 147 61 244 165 226 81 163 156 205 65 233 68 22 210 160 74 237 18 19 133 230 166 26 174 141 72 88 249 177 56 72 69 117 60 234 87
46 190 245 72 90 248 134 133 50 21 4 212 193 247 171 241 122 34 2 18 95 39 172 79 37 245 9 24 96 221 99 212 155 88 29 245 81 163 123 131 184 127 88 121 118 3 106
46 243 91 206 220 159 228 175 64 46 156 82 66 33 56 232 59 230 118 132 63 111 53 119 183 122 237 243 100 68 129 241 56 220 192 20 124 164 195 188 211 96 14 21 129 70 253
47 109 3 132 148 175 211 185 164 221 209 5 186 52 217 85 141 246 75 222 153 198 97 82 69 185 203 187 188 54 172 225 163 175 102 55 94 57 241 2 22 194 7 208 247 225 38 132
47 192 222 90 19 209 91 183 208 139 78 217 29 88 14 13 158 33 187 115 142 223 87 160 229 142 100 59 207 231 250 52 167 216 142 186 169 233 113 121 116 191 83 145 23 97 159 182
47 84 87 96 150 4 209 129 249 79 56 24 251 49 0 137 85 169 116 141 143 35 158 87 115 155 164 169 213 176 71 167 5 159 7 155 163 217 28 156 40 84 180 35 133 180 173 218
49 190 31 1 121 104 102 206 137 249 69 125 83 20 24 246 197 87 239 77 169 185 214 136 233 133 103 35 116 73 104 28 7 135 29 128 239 132 78 120 125 147 245 208 168 14 198 109 101 182
49 198 87 167 73 225 163 86 215 18 208 1 141 102 37 0 10 65 2 11 184 220 218 90 187 73 101 85 32 147 119 244 89 207 155 163 176 63 249 136 81 201 137 223 48 174 223 58 239 225
49 225 190 181 207 151 22 202 198 152 140 29 151 147 247 164 42 201 224 151 37 208 37 28 248 233 236 48 134 81 216 147 50 150 73 2 45 95 204 244 247 89 17 142 236 8 50 22 209 18
50 198 95 77 94 223 157 18 162 199 124 171 38 133 219 136 33 204 249 37 185 167 251 44 100 0 58 160 42 2 214 187 200 54 8 38 21 165 57 184 108 181 99 146 58 62 27 91 11 20 128
50 233 235 202 178 125 93 67 192 196 234 160 28 182 162 8 167 56 250 28 95 248 78 96 156 120 61 70 41 150 143 63 127 123 9 49 248 102 117 184 42 95 88 70 21 251 79 188 51 73 216
55 136 186 82 102 176 157 107 241 104 25 191 136 186 30 0 249 90 189 216 251 32 201 170 128 19 244 252 252 85 38 247 221 225 73 67 145 230 175 130 78 200 65 214 130 95 215 123 185 148 84 180 180 29 94 53
55 152 185 9 91 127 61 35 4 87 255 46 62 142 160 113 46 57 59 95 195 15 146 168 108 32 87 181 244 96 69 153 248 254 162 83 125 223 118 129 55 117 176 117 3 80 230 50 137 33 145 77 48 36 245 157
55 205 227 130 59 171 117 168 78 104 204 51 74 83 73 184 211 159 54 45 83 129 133 168 59 235 160 204 190 145 176 77 95 148 207 154 63 68 66 142 173 14 193 247 97 11 175 52 170 229 98 254 103 231 166 162
55 54 217 56 203 118 156 199 224 185 134 249 195 10 53 169 230 83 50 105 5 120 20 235 130 236 25 220 242 165 226 47 220 187 103 167 49 3 110 17 189 244 11 128 254 64 41 229 147 91 78 152 212 98 131 86
57 112 46 219 144 120 135 18 194 160 107 254 250 124 216 148 93 142 10 92 175 115 3 240 143 90 233 59 74 140 189 77 252 236 40 140 100 175 159 39 80 10 37 74 134 253 223 228 140 233 64 59 93 67 43 236 157 21
58 170 101 130 70 64 15 13 101 173 140 109 147 77 227 53 154 117 73 209 161 85 42 227 140 186 220 45 54 28 132 79 199 233 209 13 42 224 26 143 142 166 252 33 243 224 86 141 85 159 94 247 245 136 218 129 67 182 174
58 197 83 157 211 97 0 110 214 241 64 185 159 64 207 219 220 29 107 243 168 31 179 176 185 144 152 169 214 19 205 172 216 32 74 171 130 74 25 88 59 90 17 218 154 225 182 118 254 33 105 167 64 28 87 249 172 239 162
58 199 110 67 14 34 14 229 154 3 186 112 247 142 115 73 6 129 110 53 108 92 166 237 145 137 190 37 5 9 40 155 209 150 222 223 185 236 197 83 239 127 195 231 13 55 48 19 184 158 72 36 251 239 18 140 120 208 177
59 169 138 209 192 182 242 169 34 115 1 82 52 68 30 147 214 234 166 82 218 127 167 220 12 73 69 55 232 201 121 128 114 3 81 50 185 67 219 219 183 220 46 235 32 76 126 246 55 37 72 17 164 240 237 177 57 50 232 34
60 246 177 120 161 45 150 176 28 185 51 101 153 125 142 113 242 28 212 192 146 169 44 174 24 233 130 35 158 194 191 181 184 112 45 89 157 196 9 185 125 61 31 23 186 173 136 172 201 93 109 91 6 153 10 30 130 140 65 32 79
61 204 242 150 210 21 87 44 196 38 134 161 222 114 65 155 130 20 0 88 198 255 83 25 58 67 109 83 214 245 163 246 194 149 141 148 171 228 192 111 10 70 16 233 184 81 132 59 102 133 147 44 132 230 69 190 41 178 17 0 168 180
62 103 238 166 210 103 209 211 66 255 133 0 80 38 116 64 150 22 251 222 191 156 61 142 194 165 222 35 78 26 234 112 129 216 22 83 63 231 39 129 230 172 129 54 210 245 118 104 12 113 70 203 14 132 89 208 41 55 243 119 81 221 231
63 200 226 92 23 24 82 222 182 234 245 169 240 63 170 145 250 67 120 14 86 211 231 3 218 97 232 11 37 98 88 147 42 58 239 65 82 66 32 8 44 21 178 28 84 92 173 79 159 38 93 245 249 69 249 211 166 225 222 203 67 54 95 110
64 13 39 229 39 62 39 247 112 231 84 160 86 188 59 230 84 215 135 99 53 250 167 113 93 138 30 101 198 65 21 205 78 60 179 117 123 218 108 235 193 193 139 23 125 198 253 209 157 132 52 210 126 219 68 220 101 98 65 44 163 86 249 242 146
64 56 107 42 57 63 193 10 64 81 167 149 98 3 177 227 35 238 182 159 207 46 203 216 6 229 23 38 132 8 129 59 64 236 102 121 43 39 132 107 120 43 1 219 46 178 190 81 160 116 240 112 162 187 72 168 161 95 207 37 104 80 97 168 60
64 59 193 51 70 18 250 216 34 233 98 16 237 207 117 70 57 237 25 123 168 208 101 82 4 86 4 204 246 37 171 235 96 108 31 166 127 25 126 161 2 225 177 239 176 39 53 233 20 78 100 188 30 201 14 34 31 18 238 22 55 154 1 152 6
64 87 181 167 160 255 119 249 16 88 227 197 120 50 232 201 43 26 151 134 139 231 93 114 70 5 119 36 3 206 36 9 37 217 176 197 216 39 190 232 127 162 174 248 212 150 193 0 176 88 134 59 64 227 174 134 232 37 170 236 243 207 245 24 168
66 24 235 146 77 252 43 194 173 109 35 62 239 247 73 27 5 218 209 220 152 208 153 119 86 71 74 132 207 54 158 49 78 137 195 156 134 238 94 51 91 129 113 75 120 187 102 125 149 56 89 45 8 242 165 94 58 239 226 9 38 129 58 116 10 253 16
67 24 68 197 82 187 203 184 219 179 224 55 219 37 86 156 254 136 123 56 212 153 69 216 160 14 124 190 27 234 138 218 2 206 159 85 138 106 13 101 30 238 156 249 19 243 149 17 123 16 73 80 169 142 40 73 156 164 7 183 142 145 146 144 96 49 229 234
68 209 250 128 19 198 190 95 51 12 234 34 41 215 251 193 37 190 170 73 12 117 53 64 178 219 174 170 89 220 0 202 173 250 74 192 192 9 32 243 21 10 22 62 226 17 0 7 207 170 81 219 31 134 27 209 97 201 123 186 165 123 132 82 118 207 19 54 216
68 88 78 102 194 246 124 38 252 127 209 174 198 154 95 24 144 87 22 254 1 50 248 25 64 100 35 243 206 214 51 215 46 129 62 241 119 186 23 116 57 232 34 0 130 129 24 18 216 46 17 217 96 9 243 160 109 22 147 59 236 198 19 27 72 81 12 191 11
70 44 53 96 203 56 95 124 26 87 5 29 133 234 155 219 111 10 241 119 42 184 126 209 48 229 245 60 117 39 173 177 83 226 17 30 27 112 154 53 199 160 82 76 138 237 40 249 247 25 112 33 210 239 242 2 212 231 62 73 14 235 250 97 206 11 127 233 123 26 30
70 6 163 235 122 102 62 45 105 157 84 52 166 222 91 200 197 237 162 217 59 175 46 173 2 148 29 204 24 93 112 153 99 19 133 221 121 195 10 226 96 94 22 6 61 114 206 2 95 113 219 154 32 10 71 34 158 100 238 182 193 94 79 37 114 212 2 235 152 13 206
71 186 57 122 47 92 120 116 249 226 18 212 136 181 203 26 233 87 33 166 33 14 90 71 51 171 237 226 162 63 251 228 249 52 94 40 144 214 156 138 185 175 94 65 100 41 91 77 128 124 243 162 139 78 233 190 249 214 160 155 22 155 127 15 207 221 56 96 180 212 234 109
72 16 155 165 243 49 154 225 24 81 184 204 123 31 95 235 158 0 119 169 117 164 233 159 16 104 234 17 97 155 239 129 172 138 38 159 187 193 128 212 18 57 160 141 88 255 120 246 0 239 159 117 147 136 21 163 241 255 180 82 155 163 212 71 45 250 230 233 187 103 189 205 160
73 69 95 210 213 28 70 132 198 142 91 25 197 34 74 0 210 60 251 175 220 32 117 237 112 100 26 230 129 185 152 246 254 248 200 211 20 14 88 218 156 179 243 98 213 62 98 167 122 93 86 86 125 204 68 238 48 94 212 178 24 108 168 22 100 112 234 120 126 66 83 27 245 70
74 46 21 151 248 235 244 224 119 95 202 57 218 20 159 47 212 140 129 215 69 114 205 52 137 217 14 74 185 26 99 22 73 120 173 65 99 162 33 218 1 235 20 219 0 179 10 212 63 140 171 133 254 120 185 135 82 199 209 11 225 52 34 42 172 207 107 15 113 141 234 115 120 254 78
75 15 190 25 105 190 120 106 137 16 91 30 215 233 81 5 207 174 12 37 122 111 95 44 177 152 102 131 84 234 39 197 249 229 223 98 163 87 204 44 103 39 74 62 16 155 67 223 73 79 4 196 191 99 240 112 251 87 243 80 65 26 21 59 255 244 157 162 75 106 206 179 145 24 241 162
75 210 126 60 124 1 9 96 250 34 44 158 214 62 11 24 43 155 221 82 121 159 8 160 199 127 150 127 247 84 241 201 39 112 5 163 113 14 3 107 48 48 9 6 110 20 30 153 176 251 235 41 154 243 201 97 115 96 225 106 180 210 51 219 66 56 126 179 70 130 30 118 178 39 124 32
76 102 72 5 165 39 180 218 207 71 174 227 183 95 194 14 154 203 137 130 47 217 10 217 14 188 34 241 176 29 185 185 131 1 191 40 41 115 2 248 186 176 220 113 16 158 127 170 105 9 44 152 226 54 114 240 242 148 225 162 177 155 92 52 156 27 92 197 142 94 190 72 15 154 185 31 56
80 191 165 254 100 72 162 177 91 238 29 193 20 234 205 65 253 134 198 176 62 117 107 242 156 79 52 51 56 135 198 236 70 108 234 170 180 140 92 15 122 121 208 142 100 158 208 97 36 150 17 98 12 124 85 168 203 137 219 3 16 162 240 87 14 218 1 194 103 93 209 225 215 162 112 59 64 64 156 100 214
83 166 3 255 93 8 4 63 156 111 215 223 23 217 152 10 201 3 69 61 55 23 241 19 46 56 67 222 13 26 174 46 193 177 45 30 185 49 93 85 160 52 52 183 13 204 194 214 207 7 19 7 30 5 26 77 61 93 43 74 120 217 120 57 139 165 87 68 214 180 154 118 233 206 46 246 155 240 205 106 247 224 113 22
85 116 236 115 125 96 163 101 84 107 27 7 129 114 2 181 141 84 130 169 51 89 71 185 135 165 37 235 237 5 28 128 121 9 243 246 105 150 92 189 1 119 197 131 233 199 56 119 27 187 32 78 20 103 7 155 12 45 134 250 50 163 122 171 172 109 162 21 3 254 211 5 117 152 136 94 95 192 213 123 123 245 201 143 92 209
85 127 195 92 85 202 16 156 192 31 32 152 1 211 101 129 220 117 57 141 172 73 95 203 4 61 91 31 155 213 158 77 84 97 169 169 43 186 70 236 217 102 132 218 57 233 91 22 94 149 163 10 222 2 213 227 63 48 2 218 5 160 40 90 2 209 3 45 139 73 25 100 175 157 63 233 134 154 255 229 47 162 239 14 164 197
85 15 245 23 18 86 198 221 5 102 162 86 248 35 50 56 114 90 14 125 86 90 96 172 178 133 64 233 202 54 215 197 70 205 220 88 35 162 53 40 8 216 126 0 251 176 56 109 11 70 234 97 160 74 14 82 207 78 60 154 132 19 95 202 224 59 35 3 221 88 44 229 48 170 229 43 91 29 153 102 99 131 199 3 206 213
85 167 254 73 178 127 77 18 17 114 107 210 30 2 56 224 97 76 153 201 189 170 167 47 126 179 240 76 163 140 10 26 52 8 99 230 135 176 248 152 34 99 106 65 102 162 33 199 238 186 145 171 101 56 219 227 235 203 47 142 87 57 168 139 65 12 114 200 188 106 96 223 206 202 32 52 109 65 251 91 251 140 7 96 196 226
85 99 50 24 223 69 47 132 203 73 96 185 20 29 119 139 67 245 3 233 155 35 149 47 190 7 199 98 239 147 237 162 246 31 186 213 100 234 89 47 51 185 232 72 215 95 211 26 85 215 3 240 250 152 32 184 159 231 26 143 123 7 49 113 38 236 71 138 214 160 185 9 90 161 81 49 1 37 75 86 252 78 70 246 230 102
86 94 42 143 117 81 204 248 0 240 84 207 245 82 243 3 206 111 162 193 105 220 12 43 121 216 175 76 58 130 198 99 225 240 242 86 66 190 78 66 174 162 17 163 245 5 166 195 116 72 132 221 36 144 8 157 105 183 233 163 57 175 6 26 159 248 113 225 182 191 35 100 98 53 7 87 58 173 26 174 245 158 139 25 46 147 182
89 106 207 248 97 50 231 67 55 133 147 161 28 91 208 63 246 1 62 184 65 8 187 82 103 208 47 101 203 205 156 105 55 107 98 152 157 73 219 213 206 110 118 235 201 71 42 191 72 104 120 137 112 51 219 215 3 10 61 207 215 217 56 14 68 154 166 226 227 129 183 178 240 45 157 185 116 199 121 188 47 241 69 159 36 32 119 39 43 180
90 131 134 140 137 190 152 114 255 45 227 224 189 96 50 223 116 165 127 210 203 189 219 29 227 73 48 211 61 254 244 158 129 122 42 10 56 194 125 55 239 96 23 172 192 74 139 52 239 11 7 186 200 226 215 171 44 7 126 105 5 114 7 134 237 49 145 37 243 14 93 226 110 116 142 46 190 26 99 173 37 106 103 237 76 62 153 120 70 23 225
90 65 205 5 137 49 225 165 56 144 35 254 182 233 114 229 0 218 206 34 184 26 123 243 158 61 15 38 171 61 21 235 126 227 240 8 20 209 173 76 97 209 74 24 186 188 253 186 150 203 220 78 229 87 66 132 148 81 170 64 142 191 43 13 162 28 21 182 237 194 2 79 147 77 103 77 9 100 7 160 47 227 238 21 59 48 153 207 130 67 15
91 14 87 18 93 198 109 220 89 172 134 63 120 212 18 31 44 69 139 144 170 155 197 105 118 40 250 230 189 191 191 170 205 22 188 43 220 42 7 54 214 141 117 79 97 135 110 142 204 249 30 119 148 227 224 10 11 218 240 201 153 176 115 103 198 48 146 163 90 153 217 48 38 78 127 136 213 237 22 162 231 52 25 123 23 249 134 34 212 118 235 109
93 212 237 143 102 144 233 255 105 25 38 183 153 174 140 134 196 46 109 248 71 233 15 65 111 49 21 229 29 130 12 124 87 249 11 189 137 244 189 242 13 227 169 166 145 53 45 85 100 154 77 171 131 92 236 242 141 1 216 170 132 228 38 219 221 49 152 102 37 85 88 51 56 1 217 201 54 6 30 154 161 107 70 36 199 50 23 85 52 239 255 184 211 38
93 27 241 115 32 180 216 187 145 69 175 75 220 202 56 34 182 206 65 168 227 163 224 60 32 246 107 205 30 20 5 51 48 246 166 80 170 126 12 60 195 187 135 159 133 191 194 60 141 3 228 112 167 196 173 199 186 24 148 216 45 153 11 93 143 178 173 58 48 185 118 244 117 253 147 250 188 85 54 73 89 26 186 0 222 103 199 153 127 92 113 172 245 125
