3 21 78 121 
3 240 82 114 
6 245 81 246 121 146 123 
8 48 28 233 95 200 110 137 124 
9 151 158 146 146 131 137 6 5 126 
9 26 97 218 7 61 251 119 104 30 
10 209 152 75 96 105 11 147 131 26 107 
11 103 15 86 68 159 200 50 206 253 232 255 
11 242 115 167 39 189 122 172 31 190 225 67 
12 140 176 64 126 206 13 222 26 72 77 43 75 
12 47 139 71 255 205 163 48 233 7 158 1 226 
13 144 160 208 127 77 96 146 27 143 152 22 59 171 
13 60 194 0 121 200 95 242 17 169 123 86 72 100 
14 200 179 132 73 2 64 242 89 123 78 156 138 67 246 
15 224 187 192 248 49 210 12 196 221 216 49 71 137 101 49 
15 63 35 51 244 218 244 79 135 0 81 17 185 61 205 102 
16 114 46 183 32 232 200 63 145 43 183 77 94 70 210 120 197 
16 83 28 117 131 56 94 226 1 204 108 125 166 66 113 130 17 
17 230 172 59 234 48 237 162 93 210 143 116 94 191 244 179 166 13 
18 178 236 213 153 23 99 118 216 175 43 214 80 18 159 236 136 78 15 
19 133 2 243 168 140 236 19 240 70 202 76 155 203 153 5 230 208 61 156 
20 74 0 143 120 255 2 52 25 47 27 200 183 200 32 97 26 128 51 173 35 
21 48 58 193 72 177 25 120 140 185 42 55 223 157 157 27 141 3 200 130 245 115 
21 79 106 237 80 147 217 117 79 134 215 121 106 20 83 58 154 203 216 116 33 126 
22 168 224 176 61 172 112 16 2 164 51 90 159 215 212 34 162 163 3 188 247 28 207 
22 26 45 231 175 136 173 87 170 82 96 210 147 162 248 87 45 245 34 174 186 7 214 
22 76 50 129 15 139 179 100 45 203 139 81 106 162 41 45 195 58 22 46 135 114 96 
24 146 24 93 105 49 40 229 18 11 161 151 13 149 63 154 129 82 138 199 29 214 99 232 112 
26 28 186 229 230 176 168 21 84 143 76 217 224 191 92 28 169 51 81 135 193 116 70 105 121 80 134 
27 195 76 122 193 183 102 65 105 153 106 142 67 78 255 5 4 24 130 10 2 109 68 159 58 162 236 215 
28 135 53 231 48 212 190 181 97 85 5 124 12 148 133 185 31 70 172 178 17 146 157 87 143 42 201 253 123 
30 102 136 136 183 51 83 251 129 217 215 118 62 188 50 81 8 132 206 129 241 125 242 251 43 65 147 237 72 145 245 
30 173 115 226 10 140 157 116 196 88 79 236 174 111 1 129 3 107 206 14 98 184 194 16 28 121 233 232 251 182 99 
30 251 25 250 138 145 19 179 117 43 4 9 146 125 82 74 53 209 95 48 245 21 13 248 13 183 178 74 254 79 191 
31 40 209 111 14 68 211 192 223 2 213 141 80 247 96 130 154 108 173 116 113 98 189 134 123 175 212 221 22 239 80 201 
32 82 179 77 101 245 237 62 200 17 20 0 21 192 117 18 19 27 239 216 82 146 136 151 15 88 224 198 225 129 21 88 211 
33 60 77 47 87 94 93 72 246 68 231 88 132 222 184 36 105 13 66 222 102 41 84 97 44 96 25 176 92 5 230 156 65 51 
34 192 60 211 182 19 89 19 181 232 189 24 81 109 71 229 255 15 201 152 59 234 164 86 209 167 200 76 156 28 158 117 220 218 72 
36 182 137 130 183 84 194 236 172 82 186 223 150 223 246 159 223 3 122 103 56 144 67 227 218 130 203 155 216 35 232 237 218 113 111 145 198 
36 226 65 194 89 221 224 231 88 37 231 60 178 158 86 79 210 6 24 224 70 21 144 248 219 166 167 48 45 166 138 25 136 203 219 225 168 
36 56 86 32 98 214 240 87 242 252 177 226 67 193 183 149 222 67 147 109 221 69 33 80 195 81 172 215 190 144 156 175 200 243 207 42 201 
37 132 35 137 41 178 45 177 27 215 252 188 47 15 74 200 0 44 80 170 84 38 62 244 253 194 210 211 24 171 92 77 48 127 214 89 49 4 
37 168 232 42 223 167 19 72 71 72 80 117 62 103 147 177 20 28 82 43 237 53 156 86 37 126 122 91 245 189 226 233 102 202 19 69 113 39 
37 52 98 60 118 23 113 139 191 94 61 109 0 203 63 53 87 144 206 51 68 37 23 9 255 13 218 136 52 22 220 171 74 62 231 193 86 88 
38 155 161 156 142 8 133 187 165 46 155 60 49 218 56 74 193 167 110 218 252 73 48 201 55 0 40 245 146 106 186 241 5 91 142 148 99 19 79 
38 223 131 173 18 224 47 213 129 149 114 164 198 171 159 27 204 135 73 95 223 9 183 104 70 130 116 187 157 154 71 0 121 202 173 139 171 220 96 
41 17 186 243 43 160 248 19 216 128 246 217 216 25 131 51 168 36 157 160 56 65 102 185 128 32 172 51 135 101 9 53 118 196 40 161 100 33 180 60 161 170 
42 165 213 75 69 113 117 201 253 45 17 176 79 118 166 33 65 248 42 21 11 153 114 77 33 0 184 14 120 194 222 148 103 179 224 172 36 85 117 33 131 134 210 
43 157 154 152 19 203 138 206 82 241 145 41 217 146 53 166 142 162 225 120 186 154 169 185 76 255 19 92 227 113 35 78 14 189 230 33 136 112 239 218 98 128 4 59 
43 230 153 149 89 203 188 165 100 95 236 112 47 66 163 114 180 104 143 184 158 175 190 207 239 240 253 147 107 255 247 30 229 144 179 62 91 111 228 192 207 208 48 254 
45 82 140 127 134 243 42 73 163 138 25 127 155 149 105 186 208 91 125 92 145 76 116 33 70 146 131 73 16 133 22 62 216 163 189 94 150 231 168 57 113 193 184 13 87 33 
46 147 149 200 231 46 170 107 105 224 79 147 61 244 165 226 81 163 156 205 65 233 68 22 210 160 74 237 18 19 133 230 166 26 174 141 72 88 249 177 56 72 69 117 60 234 87 
46 243 91 206 220 159 228 175 64 46 156 82 66 33 56 232 59 230 118 132 63 111 53 119 183 122 237 243 100 68 129 241 56 220 192 20 124 164 195 188 211 96 14 21 129 70 253 
46 39 18 39 118 56 90 78 253 78 192 194 82 22 216 13 44 148 37 152 236 155 131 3 158 249 36 24 138 84 88 81 123 106 120 241 162 210 64 159 33 0 98 115 22 58 129 
49 156 200 67 169 151 41 9 157 68 105 80 189 139 77 99 64 213 132 175 9 86 186 173 169 134 30 76 121 32 235 177 189 179 244 102 75 29 111 232 98 216 56 31 100 133 131 164 90 7 
51 236 20 112 217 86 58 161 59 229 58 32 169 0 14 79 27 7 213 87 226 138 192 251 93 168 144 204 178 209 53 178 189 73 34 150 159 92 55 218 65 114 250 235 114 9 58 141 16 15 228 242 
53 159 194 153 255 15 229 81 183 191 165 92 86 156 94 127 191 141 138 10 119 27 14 197 54 247 210 96 79 38 50 216 197 244 113 197 4 86 22 187 22 187 23 108 88 118 235 23 3 117 33 122 145 47 
53 163 142 230 251 115 222 158 165 121 180 22 212 93 228 22 12 62 151 255 51 156 176 125 219 62 76 3 79 57 27 70 220 169 44 215 28 10 118 193 131 42 216 87 136 188 110 148 250 5 147 45 161 68 
53 217 25 171 112 247 138 41 227 79 124 211 206 63 186 220 118 234 239 47 137 56 83 132 39 101 16 159 54 193 29 16 154 54 187 10 45 69 51 17 149 175 228 99 239 158 63 101 136 47 148 17 103 232 
54 142 13 191 23 85 113 161 207 42 97 120 237 9 133 88 156 18 38 104 17 245 124 192 121 128 130 219 40 247 95 237 133 108 172 156 193 29 61 144 72 159 8 53 168 141 141 69 160 179 173 177 168 42 113 
55 152 185 9 91 127 61 35 4 87 255 46 62 142 160 113 46 57 59 95 195 15 146 168 108 32 87 181 244 96 69 153 248 254 162 83 125 223 118 129 55 117 176 117 3 80 230 50 137 33 145 77 48 36 245 157 
55 243 66 130 168 143 237 75 126 61 147 100 162 186 209 184 195 31 112 41 245 92 165 136 133 179 253 71 14 29 222 255 17 32 130 185 175 111 4 45 172 152 145 78 82 98 6 22 129 119 63 118 211 228 255 88 
56 224 155 141 102 143 55 109 188 45 52 143 156 55 83 123 61 37 169 125 229 29 223 86 105 148 52 144 73 46 199 14 14 98 155 117 241 210 226 173 255 22 60 156 78 143 23 139 180 192 8 153 221 231 240 70 123 
56 79 102 40 214 11 64 100 113 115 87 30 145 38 91 185 134 51 176 246 104 70 167 216 81 233 199 238 157 14 81 136 93 184 176 51 195 240 152 52 100 239 82 245 21 174 174 156 225 94 146 73 164 57 33 245 34 
57 114 64 95 193 198 62 222 198 71 210 235 115 195 22 175 227 155 71 247 113 127 244 48 95 26 34 171 214 56 40 224 171 105 63 108 47 125 75 245 197 29 224 56 224 246 232 195 146 47 187 3 175 175 51 14 202 86 
57 130 247 128 210 49 155 24 13 68 69 229 96 79 91 33 211 133 249 42 13 181 152 161 175 157 53 221 63 121 136 188 251 127 60 205 176 215 230 190 27 43 163 123 122 254 156 77 131 150 120 145 75 16 50 251 174 103 
57 187 105 209 104 145 29 194 80 58 193 164 204 184 11 177 29 6 32 101 69 143 147 24 228 218 9 65 203 100 213 138 31 63 92 135 208 121 73 32 179 10 196 127 194 208 48 223 214 81 68 28 224 215 52 197 178 61 
57 255 161 9 121 103 161 79 86 111 50 13 154 114 151 71 88 122 115 197 154 171 161 55 42 73 148 28 171 79 149 237 78 54 246 199 157 151 23 243 6 73 1 160 187 152 231 20 19 91 217 173 6 122 229 49 195 121 
58 197 83 157 211 97 0 110 214 241 64 185 159 64 207 219 220 29 107 243 168 31 179 176 185 144 152 169 214 19 205 172 216 32 74 171 130 74 25 88 59 90 17 218 154 225 182 118 254 33 105 167 64 28 87 249 172 239 162 
58 251 109 91 150 43 62 57 132 90 196 178 62 84 104 15 153 116 139 104 131 81 69 251 128 186 158 160 158 221 0 192 216 109 28 110 152 90 167 28 181 107 206 243 192 54 3 89 170 142 193 46 223 6 41 95 192 199 255 
60 186 250 149 13 244 38 250 149 253 97 246 169 208 189 38 104 223 85 127 232 139 181 55 191 254 84 203 219 131 101 251 61 96 144 75 84 182 69 233 179 167 223 92 119 157 131 224 124 216 95 100 100 20 155 35 18 239 239 238 115 
60 72 146 206 22 56 127 216 79 12 73 145 48 254 46 23 228 199 154 99 182 75 2 252 101 29 122 251 198 24 249 43 96 139 250 118 195 121 78 18 134 151 163 182 150 209 205 122 153 104 221 79 179 224 75 24 253 198 20 195 222 
60 74 131 254 245 103 190 100 114 4 116 91 189 198 223 248 44 100 139 88 232 113 158 166 155 80 183 155 248 108 145 98 182 21 96 171 124 30 15 238 35 131 73 224 73 41 216 117 141 99 206 118 212 108 28 111 188 212 10 181 64 
64 13 39 229 39 62 39 247 112 231 84 160 86 188 59 230 84 215 135 99 53 250 167 113 93 138 30 101 198 65 21 205 78 60 179 117 123 218 108 235 193 193 139 23 125 198 253 209 157 132 52 210 126 219 68 220 101 98 65 44 163 86 249 242 146 
65 190 144 50 124 122 81 188 34 46 171 167 7 238 174 29 255 87 169 186 238 65 109 113 175 209 213 129 140 103 32 129 37 176 180 161 42 5 93 76 52 8 244 59 247 162 88 246 249 1 177 231 66 30 89 241 239 46 114 124 149 146 253 186 67 177 
66 82 139 30 211 2 221 58 90 178 232 131 47 58 50 100 249 148 138 234 229 36 39 107 198 135 128 6 83 31 177 7 113 61 37 69 63 3 127 153 181 104 28 228 162 78 72 155 226 210 134 199 246 173 50 188 53 178 195 136 209 116 143 67 177 181 136 
66 90 150 72 249 204 125 43 118 128 205 150 86 230 225 21 71 209 167 163 134 184 110 179 241 49 239 116 76 53 8 35 143 158 107 137 106 233 180 224 105 129 118 191 103 88 213 174 41 124 81 175 53 191 98 38 241 81 154 61 134 162 96 21 64 203 158 
69 228 142 247 89 226 98 160 104 63 153 241 78 161 141 14 121 14 216 71 75 185 227 252 121 183 251 24 192 8 182 227 236 68 218 70 38 61 230 142 124 127 128 202 32 13 216 154 27 177 225 102 106 197 98 227 124 94 251 61 102 177 32 82 245 251 152 27 56 127 
70 216 173 52 41 226 200 28 50 77 209 224 34 11 128 152 79 154 215 194 93 226 140 146 73 244 57 34 174 208 99 120 168 16 172 210 243 116 238 37 194 192 5 228 203 133 124 26 31 83 220 124 53 105 14 127 93 71 161 11 24 4 131 192 21 47 146 8 164 129 45 
70 69 11 85 69 141 215 93 160 175 139 177 137 235 186 124 139 39 146 30 98 126 229 117 153 45 198 165 236 210 200 32 23 211 117 92 97 76 185 1 252 68 178 133 47 108 1 186 147 147 216 245 17 189 107 171 234 49 80 215 3 25 247 26 236 108 118 77 185 47 78 
72 31 167 128 74 44 235 246 175 121 189 193 98 165 192 52 139 6 239 145 221 169 82 161 239 139 49 241 162 106 41 246 137 208 119 211 252 98 201 172 219 134 109 62 43 45 114 183 52 97 72 17 11 154 178 250 37 227 235 200 77 20 190 214 228 53 169 225 152 115 141 115 249 
73 9 79 102 149 89 165 168 190 181 176 92 242 216 252 142 8 119 15 34 203 102 106 89 34 227 212 240 30 86 192 55 95 16 157 244 105 66 157 40 248 77 132 234 38 128 121 46 247 136 80 194 238 186 28 16 157 240 0 188 71 192 243 166 208 144 155 58 211 56 98 203 133 230 
74 2 134 123 87 238 231 54 226 134 82 244 111 158 198 86 77 217 56 229 180 214 169 64 225 77 98 99 119 79 164 233 82 43 100 169 25 75 223 251 209 49 239 64 207 181 150 29 142 206 2 67 164 172 131 134 249 230 233 112 53 141 89 135 184 189 48 209 8 15 204 218 65 187 26 
74 46 21 151 248 235 244 224 119 95 202 57 218 20 159 47 212 140 129 215 69 114 205 52 137 217 14 74 185 26 99 22 73 120 173 65 99 162 33 218 1 235 20 219 0 179 10 212 63 140 171 133 254 120 185 135 82 199 209 11 225 52 34 42 172 207 107 15 113 141 234 115 120 254 78 
77 126 26 100 63 172 76 123 113 109 177 199 134 172 68 94 36 25 160 23 178 131 45 89 68 245 34 86 63 229 8 34 99 34 135 163 206 211 30 63 64 207 6 199 123 74 37 159 100 197 182 22 72 227 112 140 217 146 227 24 119 235 59 219 13 194 126 219 149 156 26 213 108 32 156 231 107 194 
77 4 252 146 78 35 60 180 13 231 0 239 152 149 229 229 74 193 79 233 113 111 27 238 171 208 159 64 198 227 75 222 232 71 112 54 106 173 234 120 148 235 103 45 128 76 18 202 14 97 179 127 208 206 109 124 159 13 188 101 240 7 67 216 78 180 15 184 97 249 48 245 228 152 34 101 228 52 
78 190 10 78 162 84 145 244 42 18 216 191 9 24 146 176 65 159 213 122 236 231 203 3 107 9 50 162 170 22 111 18 212 122 96 118 206 242 106 248 4 66 183 13 91 74 190 156 233 147 22 213 123 225 217 230 234 11 136 149 33 248 167 245 114 8 107 64 250 214 57 254 24 240 11 115 58 201 15 
78 27 149 215 211 130 203 236 153 168 251 101 240 101 61 188 95 30 227 45 122 86 137 54 49 27 194 0 231 248 6 72 19 155 31 231 29 234 211 182 147 206 27 131 51 88 64 147 118 35 192 241 121 74 39 170 101 234 171 76 226 177 149 245 76 180 220 106 159 175 32 50 125 60 181 177 148 245 68 
80 207 187 69 250 223 49 186 220 223 75 254 193 241 72 105 67 240 45 170 188 207 188 55 161 134 60 204 249 237 191 67 189 122 136 183 89 185 113 53 152 188 52 89 173 124 194 240 108 239 154 41 191 86 96 96 221 156 44 214 137 235 25 70 101 162 253 190 91 110 243 244 42 39 77 216 163 16 200 16 255 
80 235 79 217 213 78 151 76 50 38 126 214 230 18 153 72 201 47 142 170 245 72 177 224 242 132 166 91 42 107 50 225 87 129 186 44 207 82 120 2 120 246 216 94 9 113 167 210 160 53 124 149 125 45 118 111 177 28 202 220 135 252 189 222 125 119 10 77 201 131 79 65 121 39 160 130 152 71 84 56 124 
80 86 65 218 78 126 21 175 0 241 201 248 92 94 238 165 232 165 42 108 70 151 88 16 130 35 57 40 191 58 237 109 144 46 71 222 172 92 142 172 78 87 164 170 181 146 79 157 55 122 10 125 17 98 142 147 133 199 188 69 1 169 178 146 215 249 112 131 86 254 47 164 85 211 78 10 102 157 168 157 23 
83 166 3 255 93 8 4 63 156 111 215 223 23 217 152 10 201 3 69 61 55 23 241 19 46 56 67 222 13 26 174 46 193 177 45 30 185 49 93 85 160 52 52 183 13 204 194 214 207 7 19 7 30 5 26 77 61 93 43 74 120 217 120 57 139 165 87 68 214 180 154 118 233 206 46 246 155 240 205 106 247 224 113 22 
83 71 237 64 184 213 135 206 33 15 123 61 55 112 130 25 78 62 63 223 41 140 150 97 34 239 150 115 184 80 224 127 151 205 192 79 162 71 29 195 86 153 0 141 9 130 167 87 192 230 54 233 115 204 74 149 187 224 8 116 48 232 243 199 181 179 22 87 251 52 27 81 205 27 223 214 158 134 46 94 108 100 72 223 
84 120 183 223 12 151 169 200 60 154 152 127 134 169 68 96 125 134 15 134 133 5 212 240 129 191 80 14 242 63 191 162 183 119 130 195 14 43 139 74 197 35 201 75 205 14 171 74 148 187 208 25 192 164 9 65 99 89 79 86 153 15 248 80 134 122 20 148 165 159 223 106 195 168 181 144 182 97 218 74 28 170 99 220 79 
84 162 65 246 58 35 44 172 19 31 65 245 193 242 144 29 39 44 56 131 242 198 226 176 14 241 74 199 16 130 0 217 36 65 207 95 101 252 11 120 27 76 109 220 63 253 250 102 42 50 233 28 249 203 204 7 188 22 207 204 152 207 166 189 16 117 28 117 113 39 238 140 116 91 105 179 89 99 25 131 149 2 159 142 206 
86 190 85 205 244 244 106 219 113 92 108 87 230 223 238 37 179 161 140 226 144 202 165 71 133 113 207 61 174 184 81 100 118 166 50 106 154 156 70 11 248 178 99 223 146 81 4 69 242 144 40 130 90 205 201 224 62 153 29 236 81 110 81 199 20 131 50 174 31 120 186 24 42 29 247 188 110 251 2 96 139 42 226 229 247 171 197 
86 56 191 23 20 58 56 188 129 223 121 82 178 102 146 129 106 213 251 39 225 71 89 169 165 100 218 133 180 48 115 107 104 50 131 125 109 187 57 238 154 178 64 76 24 210 205 130 167 201 169 137 16 3 50 182 103 12 59 27 61 174 135 165 225 10 34 78 197 92 60 96 14 124 172 39 79 122 169 246 67 83 127 83 86 177 9 
90 188 203 22 49 174 38 78 77 67 95 32 32 51 197 115 210 112 155 26 27 63 6 88 87 151 135 182 221 178 181 229 110 129 251 160 47 33 238 124 100 77 156 133 129 98 248 83 210 147 109 237 211 115 70 42 10 205 225 231 127 150 204 238 23 199 142 71 233 124 195 77 201 96 210 74 194 203 157 148 94 10 129 49 125 199 92 136 149 61 111 
92 60 2 235 3 144 50 236 12 245 58 214 85 12 32 23 215 190 171 54 200 45 103 70 244 195 206 137 0 61 158 212 121 160 191 125 49 241 105 61 230 163 19 60 176 52 83 135 242 255 189 186 44 37 0 32 232 206 170 233 12 72 189 133 232 124 2 25 109 108 87 83 15 106 143 191 158 227 71 144 226 4 75 14 41 75 46 18 26 216 251 38 32 
95 145 180 203 84 5 128 151 179 225 179 177 165 105 76 99 163 3 172 127 17 12 7 74 170 204 6 59 141 226 140 77 115 64 24 199 70 152 94 249 121 18 170 31 123 246 130 30 250 47 157 11 59 165 85 230 113 91 33 254 62 174 75 177 238 99 121 52 252 215 46 117 233 216 148 100 207 23 130 201 70 32 212 129 197 41 103 54 132 137 52 194 55 128 116 37 
